w w w w w w w w w w w w w w w w w w w w
w p p p p p p p p p p p p p p p p p p w
w p p p p p p p p p p p p p p p p p p w
w p p p p p p p g g g g g g p p p p p w
w p p p p p p p g f g g k p p p p p p w
w p p p p p p p g g g g g g p p p p p w
w p p p p p p p p p p p p p p p p p p w
w p p p p p p p p p p p p p p p p p p w
w w w w w w w w w w w w w w w w w w w w