w w w w w w w w w w
w p k p w w p p p w
w p p p w w p p p w
w p p p w w p p p w
w p p p g g p p p w
w p p p w w p p p w
w p p p w w p p p w
w p p p w w p p p w
w p k p w w p p f w
w w w w w w w w w w