w w w w w w w w w w
w p p p p p p p p w
w p p p p p p p p w
w p p p p p p p p w
w p p p p p p p p w
w p p p p p p p p w
w p p p p p p p p w
w p p p p p p p p w
w p p p p p p p f w
w w w w w w w w w w